111111111111111111111
100000010000010000001
111110010111010111101
100011000101000111101
101001111101010111101
101100000100010111101
101111111101000011001
100000100101110011001
111110100000010000001
100000101101010100101
101111101001110100101
100000101000000100101
111110101010100100101
100000100010110111101
101111110110100000001
100000100010000000001
111110101010111111101
100000101010000000101
101111111111111111101
100000000000000000001
111111111111111111111