111111111111111
100000000000001
100000000000001
100000000000001
100000000000001
100000000000001
100000000000001
100000000000001
100000000000001
100000000000001
100000000111001
100000000101001
100000000111001
100000000000001
111111111111111